1 -1 -1 -1 -1 -1 -1 -1 -1 -1 -1 -1
2 3 4 5 6 -1 -1 -1 -1 -1 -1 -1 
-1 -1 9 8 7 -1 -1 -1 -1 -1 -1 -1 
-1 -1 10 11 12 -1 -1 27 28 29 30 -1
-1 -1 13 -1 -1 -1 -1 24 25 26 -1 -1 
-1 -1 14 -1 -1 -1 -1 21 22 23 -1 -1 
-1 -1 15 16 17 18 19 20 -1 -1 -1 -1 
-1 -1 -1 -1 -1 -1 -1 -1 -1 -1 -1 -1 